0000000000
0P00000000
0000000000
0000000000
0000100000
0000100000
0000100000
0000100000
0000000000
0000000000
