0000100000
0P00100000
0000100000
0000100000
0000100000
0000000000
0000100000
0000100000
0000100000
0000000000
