111111111111111
1P0000000000001
100000000100001
100000000100001
100000000100001
100000000000001
100010000000001
100010000000001
100010000000001
100000000000001
100000000000001
100000000000001
100000000000001
100000000000001
111111111111111
